"date","geography","geography code","Rural Urban","Household Composition: count of Household; All households; measures: Value","Household Composition: No adults in employment in household; measures: Value","Household Composition: No adults in employment in household: With dependent children; measures: Value","Household Composition: No adults in employment in household: No dependent children; measures: Value","Household Composition: Dependent children in household: All ages; measures: Value","Household Composition: Dependent children in household: Age 0 to 4; measures: Value","Household Composition: One person in household with a long-term health problem or disability; measures: Value","Household Composition: One person in household with a long-term health problem or disability: With dependent children; measures: Value","Household Composition: One person in household with a long-term health problem or disability: No dependent children; measures: Value"
"2011","Darlington","E06000005","Total",46670,16868,2110,14758,13448,5313,12545,2113,10432
"2011","County Durham","E06000047","Total",223803,87173,10216,76957,61108,23213,69048,11056,57992
"2011","Hartlepool","E06000001","Total",40434,17410,2769,14641,12091,4597,12388,2211,10177
"2011","Middlesbrough","E06000002","Total",57203,24362,4487,19875,17841,7353,17235,3360,13875
"2011","Northumberland","E06000057","Total",138534,51811,4743,47068,36581,12859,38389,5850,32539
"2011","Redcar and Cleveland","E06000003","Total",59605,25556,3306,22250,16808,6177,18026,2951,15075
"2011","Stockton-on-Tees","E06000004","Total",79159,28224,3957,24267,25067,9964,21247,4188,17059
"2011","Gateshead","E08000037","Total",89154,34049,4337,29712,24071,9517,26680,4379,22301
"2011","Newcastle upon Tyne","E08000021","Total",117153,45670,6666,39004,30820,13008,32347,5604,26743
"2011","North Tyneside","E08000022","Total",91295,33364,3736,29628,24976,9670,25468,3984,21484
"2011","South Tyneside","E08000023","Total",67167,27965,3809,24156,18486,6782,21052,3439,17613
"2011","Sunderland","E08000024","Total",119758,47775,6158,41617,33634,12692,37272,6239,31033
"2011","Blackburn with Darwen","E06000008","Total",57353,20597,3625,16972,20061,8596,17111,3981,13130
"2011","Blackpool","E06000009","Total",64367,27600,3596,24004,16906,6568,21615,3345,18270
"2011","Cheshire East","E06000049","Total",159441,53053,4009,49044,44474,16133,39673,6045,33628
"2011","Cheshire West and Chester","E06000050","Total",141442,48044,4328,43716,39085,14452,36889,5871,31018
"2011","Halton","E06000006","Total",53312,19340,3341,15999,16663,6724,15770,3053,12717
"2011","Warrington","E06000007","Total",85140,26676,2740,23936,26286,9927,21158,3661,17497
"2011","Allerdale","E07000026","Total",42345,15766,1303,14463,10972,3931,11983,1720,10263
"2011","Barrow-in-Furness","E07000027","Total",31224,12432,1363,11069,8423,3072,10142,1607,8535
"2011","Carlisle","E07000028","Total",48342,16632,1461,15171,12345,4817,13002,1922,11080
"2011","Copeland","E07000029","Total",30536,11395,1092,10303,8115,2972,8793,1349,7444
"2011","Eden","E07000030","Total",23043,7423,308,7115,5578,1863,5832,793,5039
"2011","South Lakeland","E07000031","Total",46552,17007,630,16377,10333,3541,12173,1446,10727
"2011","Bolton","E08000001","Total",116371,42037,5779,36258,36232,14688,33358,6577,26781
"2011","Bury","E08000002","Total",78113,25755,2951,22804,23819,9489,21224,3952,17272
"2011","Manchester","E08000003","Total",204969,73239,15731,57508,58346,28258,54956,11813,43143
"2011","Oldham","E08000004","Total",89703,32290,5347,26943,30353,12759,26574,5628,20946
"2011","Rochdale","E08000005","Total",87552,32726,5311,27415,28237,11515,26609,5578,21031
"2011","Salford","E08000006","Total",103556,38330,6287,32043,28742,12753,30128,5294,24834
"2011","Stockport","E08000007","Total",121979,41475,4098,37377,35730,13887,32493,5711,26782
"2011","Tameside","E08000008","Total",94953,33846,4796,29050,28569,11631,27984,5166,22818
"2011","Trafford","E08000009","Total",94484,29867,3199,26668,29754,11765,24101,4330,19771
"2011","Wigan","E08000010","Total",136386,48281,6291,41990,41265,16083,39569,7137,32432
"2011","Burnley","E07000117","Total",37550,14505,2059,12446,10975,4608,11633,2007,9626
"2011","Chorley","E07000118","Total",44919,14104,1312,12792,13222,5015,11505,1937,9568
"2011","Fylde","E07000119","Total",34885,13921,879,13042,8172,2911,9820,1183,8637
"2011","Hyndburn","E07000120","Total",34341,12570,1754,10816,10587,4241,10334,1948,8386
"2011","Lancaster","E07000121","Total",57822,21069,1884,19185,15037,5780,15992,2468,13524
"2011","Pendle","E07000122","Total",37348,13635,1721,11914,11118,4917,11095,2041,9054
"2011","Preston","E07000123","Total",57567,19934,2745,17189,16804,7346,15504,2926,12578
"2011","Ribble Valley","E07000124","Total",24045,7764,382,7382,6804,2259,5773,828,4945
"2011","Rossendale","E07000125","Total",29058,9566,1131,8435,8721,3456,8190,1456,6734
"2011","South Ribble","E07000126","Total",46102,14470,1217,13253,13570,5138,11734,2013,9721
"2011","West Lancashire","E07000127","Total",45381,16008,1796,14212,13295,4757,12693,2207,10486
"2011","Wyre","E07000128","Total",47281,19261,1332,17929,11732,4082,14460,1926,12534
"2011","Knowsley","E08000011","Total",61323,25248,4644,20604,19611,7460,20502,4101,16401
"2011","Liverpool","E08000012","Total",206515,85807,13719,72088,53671,21051,64036,11155,52881
"2011","Sefton","E08000014","Total",117930,46887,4809,42078,32223,11658,36410,5909,30501
"2011","St. Helens","E08000013","Total",75736,29519,4158,25361,22029,8317,22966,3934,19032
"2011","Wirral","E08000015","Total",140583,56519,7259,49260,39642,14801,43678,7367,36311
"2011","East Riding of Yorkshire","E06000011","Total",143032,51253,3458,47795,37852,13119,36708,5290,31418
"2011","Kingston upon Hull, City of","E06000010","Total",112596,44205,7757,36448,32025,13913,30984,5306,25678
"2011","North East Lincolnshire","E06000012","Total",69707,26937,4064,22873,19886,7884,18708,3006,15702
"2011","North Lincolnshire","E06000013","Total",70684,24612,2761,21851,20401,8093,18899,3159,15740
"2011","York","E06000014","Total",83552,26838,2034,24804,21317,8554,19220,2712,16508
"2011","Craven","E07000163","Total",24583,8516,385,8131,6049,1980,6207,833,5374
"2011","Hambleton","E07000164","Total",38117,12623,626,11997,10114,3416,9327,1311,8016
"2011","Harrogate","E07000165","Total",67169,20510,1169,19341,18902,6850,15332,2229,13103
"2011","Richmondshire","E07000166","Total",20207,6120,459,5661,5886,2268,4813,821,3992
"2011","Ryedale","E07000167","Total",22524,7795,395,7400,5402,1878,5716,705,5011
"2011","Scarborough","E07000168","Total",49435,20605,1713,18892,11420,4258,14610,1909,12701
"2011","Selby","E07000169","Total",34559,10179,781,9398,10170,3851,8277,1373,6904
"2011","Barnsley","E08000016","Total",100734,38675,5303,33372,29335,11191,30992,5450,25542
"2011","Doncaster","E08000017","Total",126487,47257,6456,40801,37497,15267,37005,6511,30494
"2011","Rotherham","E08000018","Total",108293,40918,5392,35526,32275,12498,32144,5712,26432
"2011","Sheffield","E08000019","Total",229928,83796,11179,72617,63851,26531,62189,10977,51212
"2011","Bradford","E08000032","Total",199296,68386,11843,56543,68747,30934,52958,12550,40408
"2011","Calderdale","E08000033","Total",88621,30364,3575,26789,25996,10189,23341,4017,19324
"2011","Kirklees","E08000034","Total",173525,59009,7642,51367,53538,22057,45375,8710,36665
"2011","Leeds","E08000035","Total",320596,109082,14212,94870,88415,37640,79413,13499,65914
"2011","Wakefield","E08000036","Total",140414,51215,6230,44985,40538,15665,40825,6803,34022
"2011","Derby","E06000015","Total",102271,35909,5221,30688,31554,13632,27553,5342,22211
"2011","Leicester","E06000016","Total",123125,42115,8551,33564,41139,18734,32447,7909,24538
"2011","Nottingham","E06000018","Total",126131,48896,8685,40211,34516,15661,34244,6447,27797
"2011","Rutland","E06000017","Total",15002,4931,235,4696,3971,1404,3538,456,3082
"2011","Amber Valley","E07000032","Total",52596,18032,1784,16248,14455,5141,14409,2345,12064
"2011","Bolsover","E07000033","Total",32801,12417,1546,10871,9283,3424,10312,1796,8516
"2011","Chesterfield","E07000034","Total",46796,17719,1909,15810,12455,4628,14053,2204,11849
"2011","Derbyshire Dales","E07000035","Total",30744,10634,557,10077,7664,2420,8050,1135,6915
"2011","Erewash","E07000036","Total",48692,16579,1877,14702,13771,5224,13021,2173,10848
"2011","High Peak","E07000037","Total",38946,12415,1110,11305,11046,3967,10164,1698,8466
"2011","North East Derbyshire","E07000038","Total",43070,15861,1231,14630,11214,3868,12319,1843,10476
"2011","South Derbyshire","E07000039","Total",38992,11331,1179,10152,12035,4553,9523,1813,7710
"2011","Blaby","E07000129","Total",38686,11547,747,10800,11718,4339,8899,1514,7385
"2011","Charnwood","E07000130","Total",66516,21139,1804,19335,18716,7204,15646,2605,13041
"2011","Harborough","E07000131","Total",34898,10100,525,9575,10493,3635,7718,1260,6458
"2011","Hinckley and Bosworth","E07000132","Total",45377,14172,1081,13091,12416,4619,10870,1617,9253
"2011","Melton","E07000133","Total",21490,6371,484,5887,6036,2191,4987,804,4183
"2011","North West Leicestershire","E07000134","Total",39128,12312,1131,11181,11475,4301,9853,1671,8182
"2011","Oadby and Wigston","E07000135","Total",21339,7094,558,6536,6539,2276,5640,1059,4581
"2011","Boston","E07000136","Total",27291,9863,967,8896,7565,3111,7468,1151,6317
"2011","East Lindsey","E07000137","Total",60890,27005,2110,24895,13884,4857,18785,2601,16184
"2011","Lincoln","E07000138","Total",39825,13336,1777,11559,10203,4426,10370,1728,8642
"2011","North Kesteven","E07000139","Total",45972,15819,1005,14814,12756,4411,11898,1879,10019
"2011","South Holland","E07000140","Total",37264,13806,1175,12631,9841,3589,10348,1630,8718
"2011","South Kesteven","E07000141","Total",57344,18431,1682,16749,16386,5914,13953,2322,11631
"2011","West Lindsey","E07000142","Total",38385,13654,1135,12519,10309,3459,10296,1601,8695
"2011","Corby","E07000150","Total",25215,7703,1168,6535,8321,3649,6667,1368,5299
"2011","Daventry","E07000151","Total",31647,9161,799,8362,9527,3397,7325,1340,5985
"2011","East Northamptonshire","E07000152","Total",35662,10447,968,9479,10772,4119,8356,1461,6895
"2011","Kettering","E07000153","Total",39701,12174,1367,10807,11986,4983,9835,1783,8052
"2011","Northampton","E07000154","Total",88731,26023,3875,22148,27200,12371,20868,3966,16902
"2011","South Northamptonshire","E07000155","Total",34717,9021,460,8561,10680,3765,7450,1239,6211
"2011","Wellingborough","E07000156","Total",32057,10533,1412,9121,9668,3949,8290,1472,6818
"2011","Ashfield","E07000170","Total",50931,18250,2530,15720,15139,5907,14797,2681,12116
"2011","Bassetlaw","E07000171","Total",47667,16899,1708,15191,13406,4872,13558,2279,11279
"2011","Broxtowe","E07000172","Total",46820,16056,1375,14681,12652,4864,12252,1839,10413
"2011","Gedling","E07000173","Total",49349,16524,1568,14956,13770,5244,13112,2170,10942
"2011","Mansfield","E07000174","Total",44928,16687,2187,14500,13063,5136,13762,2484,11278
"2011","Newark and Sherwood","E07000175","Total",48773,16885,1594,15291,13650,4974,13408,2180,11228
"2011","Rushcliffe","E07000176","Total",45835,14104,786,13318,13511,4970,10554,1677,8877
"2011","Herefordshire, County of","E06000019","Total",78319,26710,2111,24599,20724,7567,20842,3269,17573
"2011","Shropshire","E06000051","Total",129674,43220,3127,40093,34303,12374,33713,5098,28615
"2011","Stoke-on-Trent","E06000021","Total",107575,41503,6318,35185,31277,13444,32666,5869,26797
"2011","Telford and Wrekin","E06000020","Total",66608,21657,3707,17950,22003,8882,17987,3880,14107
"2011","Cannock Chase","E07000192","Total",40664,13346,1686,11660,12495,4731,11570,2153,9417
"2011","East Staffordshire","E07000193","Total",47251,15373,1601,13772,13976,5513,11877,2070,9807
"2011","Lichfield","E07000194","Total",41224,13452,1060,12392,11694,4188,10448,1739,8709
"2011","Newcastle-under-Lyme","E07000195","Total",52574,18922,1699,17223,14250,5140,15145,2346,12799
"2011","South Staffordshire","E07000196","Total",44458,14940,1044,13896,12343,3920,11462,1909,9553
"2011","Stafford","E07000197","Total",55703,18438,1344,17094,15098,5623,14172,2224,11948
"2011","Staffordshire Moorlands","E07000198","Total",41772,14384,960,13424,10932,3745,11499,1714,9785
"2011","Tamworth","E07000199","Total",31617,9844,1474,8370,10109,4029,8220,1635,6585
"2011","North Warwickshire","E07000218","Total",25812,8084,705,7379,7326,2630,6868,1133,5735
"2011","Nuneaton and Bedworth","E07000219","Total",52711,17954,2238,15716,15940,6278,14146,2541,11605
"2011","Rugby","E07000220","Total",41875,12750,1244,11506,12481,4972,10001,1756,8245
"2011","Stratford-on-Avon","E07000221","Total",51928,16854,930,15924,13621,4673,12509,1785,10724
"2011","Warwick","E07000222","Total",58679,17545,1354,16191,15622,6234,12918,2070,10848
"2011","Birmingham","E08000025","Total",410736,151000,31743,119257,139418,61989,115167,27531,87636
"2011","Coventry","E08000026","Total",128592,47618,7737,39881,39894,17733,34125,6858,27267
"2011","Dudley","E08000027","Total",129867,47313,6032,41281,38620,14933,36266,6532,29734
"2011","Sandwell","E08000028","Total",121498,45765,8514,37251,41046,17756,36323,7866,28457
"2011","Solihull","E08000029","Total",86056,29972,3090,26882,25962,9204,22256,3823,18433
"2011","Walsall","E08000030","Total",107822,41659,6926,34733,34509,14256,31599,6412,25187
"2011","Wolverhampton","E08000031","Total",102177,40296,7287,33009,31987,13068,29679,5964,23715
"2011","Bromsgrove","E07000234","Total",38290,12168,763,11405,11105,3798,9430,1542,7888
"2011","Malvern Hills","E07000235","Total",32212,11882,801,11081,7941,2603,8623,1206,7417
"2011","Redditch","E07000236","Total",34722,10226,1498,8728,10893,4421,8898,1775,7123
"2011","Worcester","E07000237","Total",42042,12650,1505,11145,12081,5077,10049,1727,8322
"2011","Wychavon","E07000238","Total",49466,16386,1119,15267,13382,4578,12431,1878,10553
"2011","Wyre Forest","E07000239","Total",42985,15547,1562,13985,11261,4269,11676,1742,9934
"2011","Bedford","E06000055","Total",63812,19741,2467,17274,20128,7984,15437,3061,12376
"2011","Central Bedfordshire","E06000056","Total",104399,29068,3189,25879,32949,12565,23452,4529,18923
"2011","Luton","E06000032","Total",74293,22639,4351,18288,26855,12587,17969,4700,13269
"2011","Peterborough","E06000031","Total",74023,23218,3626,19592,24256,10883,18615,3985,14630
"2011","Southend-on-Sea","E06000033","Total",74678,26008,3068,22940,21290,8815,19719,3285,16434
"2011","Thurrock","E06000034","Total",62353,18215,3134,15081,21721,9467,15019,3239,11780
"2011","Cambridge","E07000008","Total",46714,13076,1255,11821,11253,5199,10392,1500,8892
"2011","East Cambridgeshire","E07000009","Total",34614,9518,704,8814,10415,4302,7897,1307,6590
"2011","Fenland","E07000010","Total",40620,15052,1552,13500,11068,4210,11440,1878,9562
"2011","Huntingdonshire","E07000011","Total",69333,19059,1708,17351,20928,7932,15546,2871,12675
"2011","South Cambridgeshire","E07000012","Total",59960,15620,945,14675,18688,7209,13149,2232,10917
"2011","Basildon","E07000066","Total",72746,24195,3500,20695,22513,9071,18558,3389,15169
"2011","Braintree","E07000067","Total",61043,18399,2150,16249,18706,7408,14687,2662,12025
"2011","Brentwood","E07000068","Total",30646,9501,741,8760,9010,3108,7172,1191,5981
"2011","Castle Point","E07000069","Total",36440,13354,1065,12289,9938,3369,9894,1445,8449
"2011","Chelmsford","E07000070","Total",69667,20428,1780,18648,20414,7835,15323,2629,12694
"2011","Colchester","E07000071","Total",71634,22502,2530,19972,20865,8464,16941,2982,13959
"2011","Epping Forest","E07000072","Total",51991,16190,1666,14524,15318,5844,12344,1955,10389
"2011","Harlow","E07000073","Total",34620,11039,1697,9342,10980,4769,8791,1726,7065
"2011","Maldon","E07000074","Total",25817,8574,609,7965,7100,2402,6637,1057,5580
"2011","Rochford","E07000075","Total",33564,11069,689,10380,9803,3416,8507,1395,7112
"2011","Tendring","E07000076","Total",62105,29139,2606,26533,14594,5311,19834,2698,17136
"2011","Uttlesford","E07000077","Total",31316,8251,608,7643,10107,3620,6788,1235,5553
"2011","Broxbourne","E07000095","Total",37658,11591,1629,9962,12371,4893,8979,1816,7163
"2011","Dacorum","E07000096","Total",59938,17443,1919,15524,18661,7551,13512,2460,11052
"2011","East Hertfordshire","E07000242","Total",56577,14657,1244,13413,17778,6493,11663,2094,9569
"2011","Hertsmere","E07000098","Total",39778,11454,1367,10087,13059,5170,9279,1666,7613
"2011","North Hertfordshire","E07000099","Total",53426,15445,1453,13992,16134,6359,12071,2183,9888
"2011","St Albans","E07000240","Total",56140,14721,1178,13543,18714,7764,11429,2246,9183
"2011","Stevenage","E07000243","Total",34898,10395,1601,8794,11284,4653,8340,1697,6643
"2011","Three Rivers","E07000102","Total",35108,10095,944,9151,11358,4271,8004,1425,6579
"2011","Watford","E07000103","Total",36681,9022,1215,7807,11930,5307,7706,1566,6140
"2011","Welwyn Hatfield","E07000241","Total",43613,13632,1487,12145,13186,5355,10079,1777,8302
"2011","Breckland","E07000143","Total",54519,19390,1721,17669,14918,5779,14506,2399,12107
"2011","Broadland","E07000144","Total",53336,18164,988,17176,14024,4809,13507,1884,11623
"2011","Great Yarmouth","E07000145","Total",42079,17241,2283,14958,11620,4468,12656,2225,10431
"2011","King's Lynn and West Norfolk","E07000146","Total",62977,24318,1905,22413,15978,6185,17590,2631,14959
"2011","North Norfolk","E07000147","Total",46046,20152,1157,18995,9511,3402,13538,1597,11941
"2011","Norwich","E07000148","Total",60319,21504,3098,18406,14030,6636,15774,2418,13356
"2011","South Norfolk","E07000149","Total",52809,17875,1206,16669,14113,5305,13066,1921,11145
"2011","Babergh","E07000200","Total",37522,12712,902,11810,9955,3525,9258,1406,7852
"2011","Forest Heath","E07000201","Total",25376,6951,736,6215,7186,3290,5604,907,4697
"2011","Ipswich","E07000202","Total",57298,18435,2652,15783,16814,7400,14529,2688,11841
"2011","Mid Suffolk","E07000203","Total",40306,12724,826,11898,11329,4098,9838,1568,8270
"2011","St Edmundsbury","E07000204","Total",45802,14132,1191,12941,13156,5242,10996,1870,9126
"2011","Suffolk Coastal","E07000205","Total",53558,19565,1163,18402,13879,4882,14130,2045,12085
"2011","Waveney","E07000206","Total",50883,21419,1956,19463,12873,4931,15122,2208,12914
"2011","Camden","E09000007","Total",97534,28654,4546,24108,21562,10355,21795,3916,17879
"2011","City of London","E09000001","Total",4385,996,38,958,432,195,658,71,587
"2011","Hackney","E09000012","Total",101690,29927,7689,22238,29106,14279,23783,5603,18180
"2011","Hammersmith and Fulham","E09000013","Total",80590,21192,3897,17295,18479,9083,15999,2809,13190
"2011","Haringey","E09000014","Total",101955,28563,7338,21225,31996,14240,23180,5611,17569
"2011","Islington","E09000019","Total",93556,28245,6142,22103,20950,9651,22007,4260,17747
"2011","Kensington and Chelsea","E09000020","Total",78536,22480,2842,19638,15300,7053,14091,2033,12058
"2011","Lambeth","E09000022","Total",130017,32798,7945,24853,34861,16340,26513,5685,20828
"2011","Lewisham","E09000023","Total",116091,32562,7599,24963,36923,17298,26399,5953,20446
"2011","Newham","E09000025","Total",101519,28719,8262,20457,39831,19431,24470,7594,16876
"2011","Southwark","E09000028","Total",120422,32071,7420,24651,34054,16341,26418,5870,20548
"2011","Tower Hamlets","E09000030","Total",101257,27323,7795,19528,26928,14669,20840,5742,15098
"2011","Wandsworth","E09000032","Total",130493,27840,5027,22813,31665,16474,22453,4276,18177
"2011","Westminster","E09000033","Total",105772,32036,5251,26785,20123,9806,21380,3726,17654
"2011","Barking and Dagenham","E09000002","Total",69681,24547,7279,17268,28946,14311,18751,4994,13757
"2011","Barnet","E09000003","Total",135916,37469,6596,30873,45528,19963,30924,6690,24234
"2011","Bexley","E09000004","Total",92604,29834,4162,25672,30688,12053,22750,4427,18323
"2011","Brent","E09000005","Total",110286,29849,6876,22973,37912,17180,26502,6789,19713
"2011","Bromley","E09000006","Total",130862,40893,4910,35983,39751,15848,29772,5363,24409
"2011","Croydon","E09000008","Total",145010,41516,9271,32245,51060,22233,33106,8000,25106
"2011","Ealing","E09000009","Total",124082,32891,6991,25900,42037,19507,28320,6769,21551
"2011","Enfield","E09000010","Total",119916,38761,10169,28592,44063,19042,29312,7318,21994
"2011","Greenwich","E09000011","Total",101045,30676,7130,23546,33989,16241,24422,5746,18676
"2011","Harrow","E09000015","Total",84268,22463,3675,18788,30670,12435,20323,5038,15285
"2011","Havering","E09000016","Total",97199,33252,4070,29182,29242,10981,25111,4167,20944
"2011","Hillingdon","E09000017","Total",100214,28742,5310,23432,35895,15330,23913,5828,18085
"2011","Hounslow","E09000018","Total",94902,24373,5252,19121,32763,15539,21365,5245,16120
"2011","Kingston upon Thames","E09000021","Total",63639,16440,1949,14491,19690,8610,12719,2490,10229
"2011","Merton","E09000024","Total",78757,18817,2842,15975,24894,11509,15748,3302,12446
"2011","Redbridge","E09000026","Total",99105,27955,5895,22060,38176,16942,24104,6491,17613
"2011","Richmond upon Thames","E09000027","Total",79835,19706,1989,17717,23653,10793,14830,2403,12427
"2011","Sutton","E09000029","Total",78174,21566,2849,18717,25363,10285,17375,3483,13892
"2011","Waltham Forest","E09000031","Total",96861,27279,6202,21077,33670,16122,23219,5581,17638
"2011","Bracknell Forest","E06000036","Total",45878,10914,1317,9597,14942,6314,9075,1746,7329
"2011","Brighton and Hove","E06000043","Total",121540,36791,4481,32310,29822,12134,29912,4690,25222
"2011","Isle of Wight","E06000046","Total",61085,25183,2320,22863,15263,5169,18019,2812,15207
"2011","Medway","E06000035","Total",106209,33370,5228,28142,34331,13710,26489,5568,20921
"2011","Milton Keynes","E06000042","Total",98584,25126,4306,20820,34475,15569,21525,4643,16882
"2011","Portsmouth","E06000044","Total",85473,28443,4310,24133,24482,10723,21293,3898,17395
"2011","Reading","E06000038","Total",62869,16510,2795,13715,18911,9352,12762,2660,10102
"2011","Slough","E06000039","Total",50766,12477,2911,9566,19882,9884,11388,3186,8202
"2011","Southampton","E06000045","Total",98254,32271,4539,27732,25994,12042,24641,4306,20335
"2011","West Berkshire","E06000037","Total",62340,16102,1477,14625,19253,7772,12956,2397,10559
"2011","Windsor and Maidenhead","E06000040","Total",58349,15536,1258,14278,17697,7205,11548,1949,9599
"2011","Wokingham","E06000041","Total",60332,15075,1047,14028,20018,7787,11549,2201,9348
"2011","Aylesbury Vale","E07000004","Total",69406,17618,1568,16050,22359,8758,14720,2836,11884
"2011","Chiltern","E07000005","Total",36946,11183,654,10529,11875,4150,7916,1272,6644
"2011","South Bucks","E07000006","Total",26514,7932,538,7394,8098,3005,5766,972,4794
"2011","Wycombe","E07000007","Total",67861,18255,1776,16479,21305,8527,14050,2716,11334
"2011","Eastbourne","E07000061","Total",45012,18010,1588,16422,11032,4252,12741,1926,10815
"2011","Hastings","E07000062","Total",41159,15692,2246,13446,10883,4426,12182,2104,10078
"2011","Lewes","E07000063","Total",42181,15578,1208,14370,11141,4010,11639,1781,9858
"2011","Rother","E07000064","Total",40877,17939,1155,16784,9019,3112,12303,1599,10704
"2011","Wealden","E07000065","Total",62676,21578,1294,20284,16938,5812,15875,2401,13474
"2011","Basingstoke and Deane","E07000084","Total",69315,17728,1847,15881,21727,8936,14663,2955,11708
"2011","East Hampshire","E07000085","Total",47258,13852,920,12932,13872,4855,10400,1703,8697
"2011","Eastleigh","E07000086","Total",52177,14933,1264,13669,15724,6132,12001,2085,9916
"2011","Fareham","E07000087","Total",46579,14977,859,14118,13124,4443,11245,1817,9428
"2011","Gosport","E07000088","Total",35430,11562,1471,10091,10566,4355,9138,1713,7425
"2011","Hart","E07000089","Total",35510,9009,527,8482,11663,4399,6988,1298,5690
"2011","Havant","E07000090","Total",51311,19529,2292,17237,14289,5283,14035,2386,11649
"2011","New Forest","E07000091","Total",76839,29119,1781,27338,18950,6754,20166,2840,17326
"2011","Rushmoor","E07000092","Total",36344,8544,1182,7362,12537,5370,7751,1758,5993
"2011","Test Valley","E07000093","Total",47626,13870,1097,12773,14094,5232,10931,1859,9072
"2011","Winchester","E07000094","Total",46865,14135,800,13335,13277,5014,10534,1640,8894
"2011","Ashford","E07000105","Total",47787,14621,1761,12860,15414,6089,11451,2283,9168
"2011","Canterbury","E07000106","Total",60771,22578,2167,20411,15835,5957,16273,2581,13692
"2011","Dartford","E07000107","Total",40081,11188,1628,9560,12988,5417,8893,1868,7025
"2011","Dover","E07000108","Total",48310,18052,1845,16207,12752,4931,13709,2158,11551
"2011","Gravesham","E07000109","Total",40431,13210,1811,11399,13182,5287,10309,2133,8176
"2011","Maidstone","E07000110","Total",63447,19101,2214,16887,19431,7624,14907,2840,12067
"2011","Sevenoaks","E07000111","Total",47020,14393,1123,13270,14074,5370,10753,1777,8976
"2011","Folkestone and Hythe","E07000112","Total",47379,18363,1881,16482,12327,4725,13570,2184,11386
"2011","Swale","E07000113","Total",55585,18913,2837,16076,17447,6924,14727,2919,11808
"2011","Thanet","E07000114","Total",59513,25374,3156,22218,16112,6444,18520,2991,15529
"2011","Tonbridge and Malling","E07000115","Total",48140,14036,1427,12609,15807,5829,11138,2171,8967
"2011","Tunbridge Wells","E07000116","Total",47174,13434,1303,12131,14199,5558,10503,1824,8679
"2011","Cherwell","E07000177","Total",56728,14829,1509,13320,17818,7630,12522,2323,10199
"2011","Oxford","E07000178","Total",55375,16225,2537,13688,14864,7072,11986,2122,9864
"2011","South Oxfordshire","E07000179","Total",54104,14826,971,13855,16242,6305,11595,1893,9702
"2011","Vale of White Horse","E07000180","Total",49407,13808,1013,12795,14513,5722,10746,1783,8963
"2011","West Oxfordshire","E07000181","Total",43241,11689,729,10960,12512,4920,9415,1500,7915
"2011","Elmbridge","E07000207","Total",52922,14412,1186,13226,17663,7157,10263,1715,8548
"2011","Epsom and Ewell","E07000208","Total",29784,8385,617,7768,9501,3633,6443,1144,5299
"2011","Guildford","E07000209","Total",53973,14600,1189,13411,15642,6284,10887,1775,9112
"2011","Mole Valley","E07000210","Total",35828,11171,570,10601,10052,3550,7885,1128,6757
"2011","Reigate and Banstead","E07000211","Total",55423,14860,1285,13575,17219,7084,11572,2112,9460
"2011","Runnymede","E07000212","Total",32714,9551,747,8804,9052,3769,6986,1032,5954
"2011","Spelthorne","E07000213","Total",39512,11418,1083,10335,11639,4772,8971,1598,7373
"2011","Surrey Heath","E07000214","Total",33546,8725,617,8108,10790,4001,6760,1253,5507
"2011","Tandridge","E07000215","Total",33342,9617,686,8931,10136,3787,7361,1242,6119
"2011","Waverley","E07000216","Total",49280,14730,852,13878,14417,5581,10495,1587,8908
"2011","Woking","E07000217","Total",39467,10220,936,9284,12597,5579,8143,1484,6659
"2011","Adur","E07000223","Total",26957,9807,848,8959,6983,2803,7618,1108,6510
"2011","Arun","E07000224","Total",66706,27660,1672,25988,15494,5902,18832,2449,16383
"2011","Chichester","E07000225","Total",49848,18481,1045,17436,11831,4366,12300,1477,10823
"2011","Crawley","E07000226","Total",42727,11639,1854,9785,14076,6335,9905,2117,7788
"2011","Horsham","E07000227","Total",54923,16841,1005,15836,15532,5540,12314,1954,10360
"2011","Mid Sussex","E07000228","Total",57409,16156,918,15238,17045,6511,12614,2081,10533
"2011","Worthing","E07000229","Total",47044,16764,1346,15418,12160,4957,12519,1867,10652
"2011","Bath and North East Somerset","E06000022","Total",73515,24498,1967,22531,19116,7206,17939,2709,15230
"2011","Bournemouth","E06000028","Total",82374,28818,2629,26189,18913,8193,21379,3101,18278
"2011","Bristol, City of","E06000023","Total",182747,58638,9462,49176,48487,22784,45384,7909,37475
"2011","Cornwall","E06000052","Total",230389,87159,7222,79937,58768,21473,66442,10369,56073
"2011","Isles of Scilly","E06000053","Total",989,249,2,247,196,76,208,19,189
"2011","North Somerset","E06000024","Total",88227,31190,2507,28683,23916,9223,23372,3619,19753
"2011","Plymouth","E06000026","Total",109307,39342,4747,34595,29510,12210,31164,5507,25657
"2011","Poole","E06000029","Total",63530,22250,1835,20415,16685,6633,16536,2539,13997
"2011","South Gloucestershire","E06000025","Total",107538,30967,2818,28149,32931,12546,24954,4652,20302
"2011","Swindon","E06000030","Total",88360,24712,3182,21530,27045,11266,20401,3912,16489
"2011","Torbay","E06000027","Total",59010,24994,2466,22528,14421,5329,18384,2773,15611
"2011","Wiltshire","E06000054","Total",194194,58771,5266,53505,57751,22196,46425,8343,38082
"2011","East Devon","E07000040","Total",59071,24521,990,23531,13361,4545,16688,1971,14717
"2011","Exeter","E07000041","Total",49242,16168,1492,14676,12154,5253,12346,1874,10472
"2011","Mid Devon","E07000042","Total",32758,10630,758,9872,9032,3452,8308,1306,7002
"2011","North Devon","E07000043","Total",40001,14450,1101,13349,10431,3910,10808,1581,9227
"2011","South Hams","E07000044","Total",36858,13640,699,12941,8836,2842,9912,1387,8525
"2011","Teignbridge","E07000045","Total",54003,19770,1274,18496,13570,4746,14869,2137,12732
"2011","Torridge","E07000046","Total",27986,10740,828,9912,6764,2453,7890,1131,6759
"2011","West Devon","E07000047","Total",22725,8154,470,7684,5633,1948,6218,929,5289
"2011","Christchurch","E07000048","Total",21475,9649,448,9201,4825,1698,6499,776,5723
"2011","East Dorset","E07000049","Total",37564,15101,599,14502,8952,2898,10028,1255,8773
"2011","North Dorset","E07000050","Total",28670,9778,581,9197,7295,2816,7267,1033,6234
"2011","Purbeck","E07000051","Total",19583,7423,405,7018,4697,1647,5443,721,4722
"2011","West Dorset","E07000052","Total",44386,17587,807,16780,9953,3382,12341,1515,10826
"2011","Weymouth and Portland","E07000053","Total",28535,10894,998,9896,7202,2684,8346,1289,7057
"2011","Cheltenham","E07000078","Total",50929,15776,1424,14352,12326,5084,11288,1539,9749
"2011","Cotswold","E07000079","Total",36236,11835,559,11276,8901,3055,8511,1067,7444
"2011","Forest of Dean","E07000080","Total",34167,11793,861,10932,9046,3176,9367,1466,7901
"2011","Gloucester","E07000081","Total",50363,14909,1829,13080,15521,6466,12434,2290,10144
"2011","Stroud","E07000082","Total",47794,14866,954,13912,13168,4679,11731,1760,9971
"2011","Tewkesbury","E07000083","Total",35126,11096,691,10405,9513,3610,8377,1243,7134
"2011","Mendip","E07000187","Total",46157,15052,1239,13813,12609,4540,11973,1911,10062
"2011","Sedgemoor","E07000188","Total",48801,17225,1553,15672,13301,4926,13300,2102,11198
"2011","South Somerset","E07000189","Total",69501,24280,1648,22632,17970,6849,17891,2511,15380
"2011","Taunton Deane","E07000190","Total",46907,15793,1268,14525,12823,4875,12000,1768,10232
"2011","West Somerset","E07000191","Total",15623,6953,363,6590,3050,1099,4893,576,4317
"2011","Isle of Anglesey","W06000001","Total",30594,12322,1100,11222,7764,3016,9398,1314,8084
"2011","Gwynedd","W06000002","Total",52473,20333,1726,18607,13015,5219,15284,2124,13160
"2011","Conwy","W06000003","Total",51177,21337,1746,19591,12516,4547,15797,2156,13641
"2011","Denbighshire","W06000004","Total",40546,15941,1631,14310,11021,4164,12355,1973,10382
"2011","Flintshire","W06000005","Total",63781,21392,2261,19131,18924,7373,17852,3088,14764
"2011","Wrexham","W06000006","Total",57029,19852,2560,17292,17034,7103,16246,2913,13333
"2011","Powys","W06000023","Total",58345,20867,1488,19379,14713,5157,17051,2410,14641
"2011","Ceredigion","W06000008","Total",31562,12312,845,11467,7204,2708,9365,1288,8077
"2011","Pembrokeshire","W06000009","Total",53122,20782,2167,18615,14392,5266,15877,2603,13274
"2011","Carmarthenshire","W06000010","Total",78829,31243,3526,27717,21840,8205,25479,4271,21208
"2011","Swansea","W06000011","Total",103497,41525,4979,36546,27695,10567,32178,5385,26793
"2011","Neath Port Talbot","W06000012","Total",60393,25161,3333,21828,17033,6178,21063,3659,17404
"2011","Bridgend","W06000013","Total",58515,22591,2922,19669,17226,6266,18509,3391,15118
"2011","Vale of Glamorgan","W06000014","Total",53505,18923,2118,16805,15858,5890,15186,2693,12493
"2011","Cardiff","W06000015","Total",142557,48007,7376,40631,39508,17383,37719,7063,30656
"2011","Rhondda Cynon Taff","W06000016","Total",99663,40356,5978,34378,29963,11730,32820,6069,26751
"2011","Merthyr Tydfil","W06000024","Total",24264,9550,1528,8022,7654,2978,8299,1675,6624
"2011","Caerphilly","W06000018","Total",74479,28643,4497,24146,23550,9133,23979,4888,19091
"2011","Blaenau Gwent","W06000019","Total",30416,13304,2076,11228,8853,3328,10506,1816,8690
"2011","Torfaen","W06000020","Total",38524,14963,1965,12998,11633,4361,12223,2255,9968
"2011","Monmouthshire","W06000021","Total",38233,13451,984,12467,10641,3637,10901,1640,9261
"2011","Newport","W06000022","Total",61172,22854,3466,19388,18943,7596,17796,3405,14391
