"date","geography","geography code","Rural Urban","Living Arrangement: All categories: Living arrangements; measures: Value","Living Arrangement: Living in a couple; measures: Value","Living Arrangement: Living in a couple: Married or in a registered same-sex civil partnership; measures: Value","Living Arrangement: Living in a couple: Cohabiting; measures: Value","Living Arrangement: Not living in a couple; measures: Value","Living Arrangement: Not living in a couple: Single (never married or never registered a same-sex civil partnership); measures: Value","Living Arrangement: Not living in a couple: Married or in a registered same-sex civil partnership; measures: Value","Living Arrangement: Not living in a couple: Separated (but still legally married or still legally in a same-sex civil partnership); measures: Value","Living Arrangement: Not living in a couple: Divorced or formerly in a same-sex civil partnership which is now legally dissolved; measures: Value","Living Arrangement: Not living in a couple: Widowed or surviving partner from a same-sex civil partnership; measures: Value"
"2011","Darlington","E06000005","Total",83954,49614,38963,10651,34340,19424,730,1942,6564,5680
"2011","County Durham","E06000047","Total",412617,244235,195620,48615,168382,97195,3540,8597,29133,29917
"2011","Hartlepool","E06000001","Total",73296,41615,32334,9281,31681,18753,599,1494,5428,5407
"2011","Middlesbrough","E06000002","Total",108161,56375,43816,12559,51786,32968,1396,2469,7441,7512
"2011","Northumberland","E06000057","Total",256897,162592,133155,29437,94305,51272,2374,5305,16570,18784
"2011","Redcar and Cleveland","E06000003","Total",109763,64735,51528,13207,45028,25849,823,2130,7901,8325
"2011","Stockton-on-Tees","E06000004","Total",150859,90549,71209,19340,60310,36116,1436,3136,9964,9658
"2011","Gateshead","E08000037","Total",162253,92676,71136,21540,69577,41422,1581,3595,11270,11709
"2011","Newcastle upon Tyne","E08000021","Total",223319,105633,80388,25245,117686,82140,3115,4709,14168,13554
"2011","North Tyneside","E08000022","Total",163435,95366,75058,20308,68069,38774,1387,3824,12220,11864
"2011","South Tyneside","E08000023","Total",120807,64897,51904,12993,55910,32293,1223,2927,9741,9726
"2011","Sunderland","E08000024","Total",223722,126019,99934,26085,97703,59521,1831,4554,15337,16460
"2011","Blackburn with Darwen","E06000008","Total",111628,63490,51277,12213,48138,29039,2060,2831,7516,6692
"2011","Blackpool","E06000009","Total",112758,58738,43184,15554,54020,29900,1102,2921,11160,8937
"2011","Cheshire East","E06000049","Total",299338,189231,154967,34264,110107,61977,2738,5267,19571,20554
"2011","Cheshire West and Chester","E06000050","Total",268208,163364,132646,30718,104844,61625,2292,4478,17952,18497
"2011","Halton","E06000006","Total",99953,56905,44282,12623,43048,26260,781,2036,7301,6670
"2011","Warrington","E06000007","Total",160091,99168,79402,19766,60923,35935,1306,2996,10694,9992
"2011","Allerdale","E07000026","Total",78768,48903,40486,8417,29865,16614,721,1256,5136,6138
"2011","Barrow-in-Furness","E07000027","Total",56110,32639,25880,6759,23471,13152,487,1059,4521,4252
"2011","Carlisle","E07000028","Total",87721,51537,41088,10449,36184,21006,787,1823,6114,6454
"2011","Copeland","E07000029","Total",57344,35394,28906,6488,21950,12539,651,868,3771,4121
"2011","Eden","E07000030","Total",43075,27834,23300,4534,15241,8536,427,600,2528,3150
"2011","South Lakeland","E07000031","Total",85158,54948,45712,9236,30210,15771,995,1184,5453,6807
"2011","Bolton","E08000001","Total",217886,124836,98802,26034,93050,55177,2763,5099,15566,14445
"2011","Bury","E08000002","Total",145999,85944,68245,17699,60055,35525,1471,3499,10162,9398
"2011","Manchester","E08000003","Total",383791,160050,109251,50799,223741,161923,8879,10981,23152,18806
"2011","Oldham","E08000004","Total",172735,97649,77152,20497,75086,43934,3168,4676,11377,11931
"2011","Rochdale","E08000005","Total",164801,91666,70851,20815,73135,43528,2371,4618,11739,10879
"2011","Salford","E08000006","Total",183248,93030,67041,25989,90218,57874,2479,4883,13037,11945
"2011","Stockport","E08000007","Total",227535,134268,108439,25829,93267,55018,2093,4638,15591,15927
"2011","Tameside","E08000008","Total",175048,98967,74680,24287,76081,44846,1713,4222,13326,11974
"2011","Trafford","E08000009","Total",179464,105614,85188,20426,73850,44846,2331,3508,11493,11672
"2011","Wigan","E08000010","Total",255780,153906,119464,34442,101874,60198,2011,5207,17863,16595
"2011","Burnley","E07000117","Total",68995,38915,30096,8819,30080,17289,952,1769,5348,4722
"2011","Chorley","E07000118","Total",84670,53760,42962,10798,30910,17676,620,1648,5713,5253
"2011","Fylde","E07000119","Total",62064,37572,31676,5896,24492,12705,558,1247,4690,5292
"2011","Hyndburn","E07000120","Total",63454,36402,28214,8188,27052,15567,807,1701,4766,4211
"2011","Lancaster","E07000121","Total",106820,61610,48422,13188,45210,26900,1131,1984,7709,7486
"2011","Pendle","E07000122","Total",70543,41412,32614,8798,29131,16457,1244,1670,5061,4699
"2011","Preston","E07000123","Total",107625,57284,44700,12584,50341,32556,1641,2229,7386,6529
"2011","Ribble Valley","E07000124","Total",45531,29492,24841,4651,16039,8749,400,856,2773,3261
"2011","Rossendale","E07000125","Total",54102,32546,24772,7774,21556,12472,560,1293,3826,3405
"2011","South Ribble","E07000126","Total",88337,55651,44938,10713,32686,18926,702,1623,5634,5801
"2011","West Lancashire","E07000127","Total",88722,53361,44546,8815,35361,21287,684,1699,5669,6022
"2011","Wyre","E07000128","Total",88765,55478,45702,9776,33287,17328,891,1540,6075,7453
"2011","Knowsley","E08000011","Total",116324,58112,45700,12412,58212,37562,1000,3041,7825,8784
"2011","Liverpool","E08000012","Total",372082,158540,119604,38936,213542,148685,4733,10040,25991,24093
"2011","Sefton","E08000014","Total",222413,123648,101436,22212,98765,58045,2052,4424,16184,18060
"2011","St. Helens","E08000013","Total",142062,82860,66272,16588,59202,35052,1070,2991,9668,10421
"2011","Wirral","E08000015","Total",257140,140406,113377,27029,116734,68324,2250,5543,20865,19752
"2011","East Riding of Yorkshire","E06000011","Total",271218,179243,146963,32280,91975,49682,2492,4669,16235,18897
"2011","Kingston upon Hull, City of","E06000010","Total",204411,106483,74966,31517,97928,62626,2211,4968,15612,12511
"2011","North East Lincolnshire","E06000012","Total",127574,74539,56732,17807,53035,30291,1230,2672,10041,8801
"2011","North Lincolnshire","E06000013","Total",134555,84919,66470,18449,49636,27302,1456,2502,9278,9098
"2011","York","E06000014","Total",158773,91792,70887,20905,66981,42917,1888,2486,9879,9811
"2011","Craven","E07000163","Total",45273,29146,24324,4822,16127,8429,474,769,3002,3453
"2011","Hambleton","E07000164","Total",72230,48150,40738,7412,24080,12897,716,1164,4053,5250
"2011","Harrogate","E07000165","Total",125493,80991,67112,13879,44502,24238,1372,2112,8413,8367
"2011","Richmondshire","E07000166","Total",38205,25780,21956,3824,12425,6436,533,725,2271,2460
"2011","Ryedale","E07000167","Total",42344,27854,23198,4656,14490,7639,413,710,2385,3343
"2011","Scarborough","E07000168","Total",89149,53410,42762,10648,35739,18576,1128,1833,6875,7327
"2011","Selby","E07000169","Total",67530,45607,36938,8669,21923,12344,629,1195,3814,3941
"2011","Barnsley","E08000016","Total",186674,114804,87674,27130,71870,40420,1483,3579,13384,13004
"2011","Doncaster","E08000017","Total",239750,144862,111222,33640,94888,53747,2621,5073,17017,16430
"2011","Rotherham","E08000018","Total",206080,127461,100339,27122,78619,44826,2134,3814,13458,14387
"2011","Sheffield","E08000019","Total",438452,236471,181016,55455,201981,134683,5974,8269,25830,27225
"2011","Bradford","E08000032","Total",393444,225652,181994,43658,167792,99564,9386,10362,24631,23849
"2011","Calderdale","E08000033","Total",162269,96349,74207,22142,65920,37391,1934,3950,11968,10677
"2011","Kirklees","E08000034","Total",330768,197373,156865,40508,133395,79032,5003,7326,21670,20364
"2011","Leeds","E08000035","Total",594091,322262,246399,75863,271829,177398,7398,12973,37840,36220
"2011","Wakefield","E08000036","Total",262266,160905,124690,36215,101361,56677,2431,5421,18969,17863
"2011","Derby","E06000015","Total",193977,109202,84887,24315,84775,52303,3012,4307,12744,12409
"2011","Leicester","E06000016","Total",252346,126897,102044,24853,125449,83494,7200,5791,14618,14346
"2011","Nottingham","E06000018","Total",234289,104366,73860,30506,129923,91440,4275,5504,15858,12846
"2011","Rutland","E06000017","Total",28164,19104,16188,2916,9060,4608,298,532,1640,1982
"2011","Amber Valley","E07000032","Total",99723,64001,50237,13764,35722,20025,714,1787,6443,6753
"2011","Bolsover","E07000033","Total",61577,38562,29768,8794,23015,12603,528,1272,4072,4540
"2011","Chesterfield","E07000034","Total",84493,50855,39257,11598,33638,18891,657,1686,6495,5909
"2011","Derbyshire Dales","E07000035","Total",57877,38051,31782,6269,19826,10581,528,960,3428,4329
"2011","Erewash","E07000036","Total",90856,56607,43570,13037,34249,19622,672,1816,6135,6004
"2011","High Peak","E07000037","Total",73412,45578,35838,9740,27834,15972,544,1419,5031,4868
"2011","North East Derbyshire","E07000038","Total",81958,52970,43316,9654,28988,15809,618,1411,5009,6141
"2011","South Derbyshire","E07000039","Total",74708,49630,39220,10410,25078,14392,603,1413,4399,4271
"2011","Blaby","E07000129","Total",75314,48902,39782,9120,26412,15161,695,1422,4345,4789
"2011","Charnwood","E07000130","Total",130566,78512,63226,15286,52054,32826,1273,2421,7428,8106
"2011","Harborough","E07000131","Total",67688,45742,38008,7734,21946,12402,546,1198,3601,4199
"2011","Hinckley and Bosworth","E07000132","Total",85731,55935,44880,11055,29796,16744,645,1792,5122,5493
"2011","Melton","E07000133","Total",40816,26805,21596,5209,14011,7769,313,798,2447,2684
"2011","North West Leicestershire","E07000134","Total",75046,48657,38938,9719,26389,14954,652,1408,4545,4830
"2011","Oadby and Wigston","E07000135","Total",43956,27322,22964,4358,16634,9698,745,691,2287,3213
"2011","Boston","E07000136","Total",52375,32792,25268,7524,19583,10431,755,956,3681,3760
"2011","East Lindsey","E07000137","Total",112546,73584,60223,13361,38962,19212,1046,1916,7499,9289
"2011","Lincoln","E07000138","Total",72591,38957,27488,11469,33634,21247,732,1409,6028,4218
"2011","North Kesteven","E07000139","Total",86941,59177,49134,10043,27764,14380,711,1468,5196,6009
"2011","South Holland","E07000140","Total",72510,47933,37898,10035,24577,12666,926,1290,4207,5488
"2011","South Kesteven","E07000141","Total",107888,70802,57167,13635,37086,19846,941,2293,6929,7077
"2011","West Lindsey","E07000142","Total",72402,48127,39542,8585,24275,12872,607,1232,4524,5040
"2011","Corby","E07000150","Total",48376,28325,20804,7521,20051,11799,574,1401,3350,2927
"2011","Daventry","E07000151","Total",61198,40944,33362,7582,20254,11294,539,1329,3559,3533
"2011","East Northamptonshire","E07000152","Total",68117,45461,35974,9487,22656,12559,615,1478,4171,3833
"2011","Kettering","E07000153","Total",73866,46754,36564,10190,27112,15262,680,1817,4919,4434
"2011","Northampton","E07000154","Total",165492,94280,70905,23375,71212,43734,2398,4628,11448,9004
"2011","South Northamptonshire","E07000155","Total",67992,46800,39097,7703,21192,11912,534,1253,3641,3852
"2011","Wellingborough","E07000156","Total",59581,36468,28898,7570,23113,13130,610,1486,4108,3779
"2011","Ashfield","E07000170","Total",95414,59591,45743,13848,35823,20345,708,2133,6406,6231
"2011","Bassetlaw","E07000171","Total",89999,57446,45944,11502,32553,17704,823,1758,5964,6304
"2011","Broxtowe","E07000172","Total",90032,55937,44652,11285,34095,20422,881,1550,5323,5919
"2011","Gedling","E07000173","Total",92402,57127,45176,11951,35275,20394,807,1855,6096,6123
"2011","Mansfield","E07000174","Total",84481,51803,39652,12151,32678,18390,745,1747,6031,5765
"2011","Newark and Sherwood","E07000175","Total",91705,58837,47320,11517,32868,17902,739,1747,6104,6376
"2011","Rushcliffe","E07000176","Total",88229,57058,47646,9412,31171,18542,657,1398,4925,5649
"2011","Herefordshire, County of","E06000019","Total",149286,94141,76626,17515,55145,30508,1588,2518,9997,10534
"2011","Shropshire","E06000051","Total",245878,156489,126812,29677,89389,49919,2248,3862,16100,17260
"2011","Stoke-on-Trent","E06000021","Total",197728,110953,84486,26467,86775,51934,2351,4497,14307,13686
"2011","Telford and Wrekin","E06000020","Total",130362,79730,61416,18314,50632,30019,1284,2743,9076,7510
"2011","Cannock Chase","E07000192","Total",78394,49631,38221,11410,28763,16744,584,1420,4946,5069
"2011","East Staffordshire","E07000193","Total",89815,55699,44536,11163,34116,19692,1052,1782,5625,5965
"2011","Lichfield","E07000194","Total",81345,54126,44378,9748,27219,15438,762,1318,4610,5091
"2011","Newcastle-under-Lyme","E07000195","Total",98665,59662,47584,12078,39003,22795,876,1847,6273,7212
"2011","South Staffordshire","E07000196","Total",88569,57806,48542,9264,30763,17842,811,1231,4696,6183
"2011","Stafford","E07000197","Total",105411,67004,54914,12090,38407,22084,1018,1903,6562,6840
"2011","Staffordshire Moorlands","E07000198","Total",79897,51928,42948,8980,27969,15570,627,1291,4533,5948
"2011","Tamworth","E07000199","Total",61101,37931,29542,8389,23170,13749,418,1263,4234,3506
"2011","North Warwickshire","E07000218","Total",50511,32357,25770,6587,18154,10524,453,920,2989,3268
"2011","Nuneaton and Bedworth","E07000219","Total",100413,61565,49185,12380,38848,22472,955,2031,6687,6703
"2011","Rugby","E07000220","Total",79091,50177,39882,10295,28914,16558,845,1710,4937,4864
"2011","Stratford-on-Avon","E07000221","Total",98424,64195,53688,10507,34229,18619,959,1615,6087,6949
"2011","Warwick","E07000222","Total",111014,64613,51720,12893,46401,29497,1214,1944,7001,6745
"2011","Birmingham","E08000025","Total",806895,394826,317370,77456,412069,271446,19130,22339,49544,49610
"2011","Coventry","E08000026","Total",244912,126880,100869,26011,118032,75851,4405,5661,16368,15747
"2011","Dudley","E08000027","Total",251130,153504,123915,29589,97626,57779,2468,4699,14897,17783
"2011","Sandwell","E08000028","Total",239729,131540,104285,27255,108189,65208,4799,6109,14614,17459
"2011","Solihull","E08000029","Total",165913,100098,84510,15588,65815,39325,1592,3227,9812,11859
"2011","Walsall","E08000030","Total",211229,123458,98408,25050,87771,51859,3427,4489,12727,15269
"2011","Wolverhampton","E08000031","Total",196212,103266,82501,20765,92946,57463,3952,4337,13035,14159
"2011","Bromsgrove","E07000234","Total",74470,48865,40954,7911,25605,14447,606,1245,4266,5041
"2011","Malvern Hills","E07000235","Total",60386,39124,32524,6600,21262,11321,580,949,3875,4537
"2011","Redditch","E07000236","Total",67190,41477,32285,9192,25713,15406,639,1431,4646,3591
"2011","Worcester","E07000237","Total",78425,45919,34912,11007,32506,20186,678,1491,5622,4529
"2011","Wychavon","E07000238","Total",95642,63558,52630,10928,32084,17360,831,1482,5759,6652
"2011","Wyre Forest","E07000239","Total",80272,49785,39630,10155,30487,16815,636,1594,5725,5717
"2011","Bedford","E06000055","Total",123054,72909,59664,13245,50145,29805,1913,2687,8252,7488
"2011","Central Bedfordshire","E06000056","Total",202364,130487,105128,25359,71877,41901,1931,4191,12173,11681
"2011","Luton","E06000032","Total",154803,82732,67605,15127,72071,46453,4650,3940,8949,8079
"2011","Peterborough","E06000031","Total",142704,83266,64099,19167,59438,34824,2445,3713,10304,8152
"2011","Southend-on-Sea","E06000033","Total",138473,78699,59502,19197,59774,34655,1693,3304,10879,9243
"2011","Thurrock","E06000034","Total",122795,73736,56606,17130,49059,29807,1803,2930,7662,6857
"2011","Cambridge","E07000008","Total",89749,45921,33750,12171,43828,31199,1685,1398,5322,4224
"2011","East Cambridgeshire","E07000009","Total",66837,45415,36174,9241,21422,12086,688,1134,3576,3938
"2011","Fenland","E07000010","Total",77167,48744,38140,10604,28423,15171,823,1608,5036,5785
"2011","Huntingdonshire","E07000011","Total",134674,88793,71022,17771,45881,26416,1342,2517,8057,7549
"2011","South Cambridgeshire","E07000012","Total",117373,79423,65484,13939,37950,22425,1186,1827,5959,6553
"2011","Basildon","E07000066","Total",138082,81928,65186,16742,56154,32771,1266,3239,9836,9042
"2011","Braintree","E07000067","Total",116494,74635,59746,14889,41859,23888,922,2319,7700,7030
"2011","Brentwood","E07000068","Total",59329,36732,30463,6269,22597,13494,661,1026,3495,3921
"2011","Castle Point","E07000069","Total",72519,45623,38002,7621,26896,15257,655,1291,4251,5442
"2011","Chelmsford","E07000070","Total",134974,85050,69010,16040,49924,30468,1198,2287,8268,7703
"2011","Colchester","E07000071","Total",135447,81535,64658,16877,53912,32831,1365,2546,9478,7692
"2011","Epping Forest","E07000072","Total",100672,60592,49472,11120,40080,23945,1048,1943,6245,6899
"2011","Harlow","E07000073","Total",64675,36854,28286,8568,27821,16063,750,1539,5073,4396
"2011","Maldon","E07000074","Total",50274,33261,27550,5711,17013,9324,449,894,3020,3326
"2011","Rochford","E07000075","Total",67722,44405,37062,7343,23317,13225,648,1064,3674,4706
"2011","Tendring","E07000076","Total",113333,68278,56398,11880,45055,22471,1171,2317,8439,10657
"2011","Uttlesford","E07000077","Total",62387,42070,34622,7448,20317,11694,642,1021,3421,3539
"2011","Broxbourne","E07000095","Total",74542,44404,35620,8784,30138,18516,777,1576,4647,4622
"2011","Dacorum","E07000096","Total",114093,70484,56256,14228,43609,25665,1222,2330,7488,6904
"2011","East Hertfordshire","E07000242","Total",108547,69898,56406,13492,38649,23419,973,1922,6200,6135
"2011","Hertsmere","E07000098","Total",78407,46296,38764,7532,32111,19712,1041,1558,4958,4842
"2011","North Hertfordshire","E07000099","Total",101139,63820,51104,12716,37319,21815,1121,1971,6102,6310
"2011","St Albans","E07000240","Total",109120,70298,58320,11978,38822,24260,1190,1701,5802,5869
"2011","Stevenage","E07000243","Total",66323,38520,30026,8494,27803,16637,743,1603,4864,3956
"2011","Three Rivers","E07000102","Total",68887,42728,35660,7068,26159,15798,828,1211,4061,4261
"2011","Watford","E07000103","Total",70978,39967,31426,8541,31011,20231,1344,1592,4277,3567
"2011","Welwyn Hatfield","E07000241","Total",86752,48675,38886,9789,38077,25048,1122,1702,5033,5172
"2011","Breckland","E07000143","Total",104708,69007,55055,13952,35701,18984,1099,1932,6546,7140
"2011","Broadland","E07000144","Total",101983,68713,56668,12045,33270,17655,735,1578,6089,7213
"2011","Great Yarmouth","E07000145","Total",78721,47242,36175,11067,31479,17296,773,1482,6109,5819
"2011","King's Lynn and West Norfolk","E07000146","Total",120474,78899,63019,15880,41575,21814,1363,1958,7609,8831
"2011","North Norfolk","E07000147","Total",84578,55141,45102,10039,29437,14218,954,1351,5616,7298
"2011","Norwich","E07000148","Total",106075,52908,35646,17262,53167,34721,1181,2285,8877,6103
"2011","South Norfolk","E07000149","Total",100342,68147,55406,12741,32195,17108,880,1669,5905,6633
"2011","Babergh","E07000200","Total",70625,46613,38576,8037,24012,12856,577,1297,4394,4888
"2011","Forest Heath","E07000201","Total",47175,29888,23243,6645,17287,9591,744,909,3318,2725
"2011","Ipswich","E07000202","Total",105327,61043,45030,16013,44284,26969,1302,2399,7469,6145
"2011","Mid Suffolk","E07000203","Total",77472,52911,43864,9047,24561,13473,648,1324,4240,4876
"2011","St Edmundsbury","E07000204","Total",87744,56383,45316,11067,31361,17669,848,1632,5621,5591
"2011","Suffolk Coastal","E07000205","Total",100144,66011,55016,10995,34133,17704,1128,1801,6125,7375
"2011","Waveney","E07000206","Total",93671,58611,46460,12151,35060,18309,816,1649,6778,7508
"2011","Camden","E09000007","Total",177049,72762,49751,23011,104287,75991,5099,4371,11766,7060
"2011","City of London","E09000001","Total",6595,2848,1954,894,3747,2537,371,141,430,268
"2011","Hackney","E09000012","Total",193328,72872,47102,25770,120456,89336,5305,7038,12355,6422
"2011","Hammersmith and Fulham","E09000013","Total",151028,60569,41521,19048,90459,68170,3820,3698,9517,5254
"2011","Haringey","E09000014","Total",201171,86857,61445,25412,114314,80180,6165,6686,13878,7405
"2011","Islington","E09000019","Total",167327,65446,40044,25402,101881,76767,3492,4762,10697,6163
"2011","Kensington and Chelsea","E09000020","Total",131569,57375,42979,14396,74194,51419,5060,3141,9579,4995
"2011","Lambeth","E09000022","Total",245327,93942,59000,34942,151385,114034,6638,7824,14969,7920
"2011","Lewisham","E09000023","Total",216216,93900,66456,27444,122316,85790,5335,7456,14533,9202
"2011","Newham","E09000025","Total",236115,98859,81139,17720,137256,93879,14133,7366,12652,9226
"2011","Southwark","E09000028","Total",229266,92839,59596,33243,136427,97552,7666,8090,14941,8178
"2011","Tower Hamlets","E09000030","Total",200214,81253,57568,23685,118961,89494,6964,5492,9732,7279
"2011","Wandsworth","E09000032","Total",250679,115844,78418,37426,134835,102672,5164,5138,13204,8657
"2011","Westminster","E09000033","Total",180764,73790,54248,19542,106974,74805,7319,5333,12430,7087
"2011","Barking and Dagenham","E09000002","Total",136615,66679,53098,13581,69936,43773,3845,4591,9669,8058
"2011","Barnet","E09000003","Total",278406,147043,123836,23207,131363,86175,7445,6519,16526,14698
"2011","Bexley","E09000004","Total",183338,104704,85140,19564,78634,48503,2575,4296,11060,12200
"2011","Brent","E09000005","Total",246156,112715,93979,18736,133441,89684,12381,7049,13270,11057
"2011","Bromley","E09000006","Total",246537,143427,116982,26445,103110,63660,2949,5495,15419,15587
"2011","Croydon","E09000008","Total",281203,142151,114184,27967,139052,91494,7033,7890,18401,14234
"2011","Ealing","E09000009","Total",265985,130708,107102,23606,135277,89942,11030,6509,15160,12636
"2011","Enfield","E09000010","Total",240067,120744,100596,20148,119323,77277,5620,7660,16028,12738
"2011","Greenwich","E09000011","Total",194610,94241,70786,23455,100369,65887,5914,5993,13125,9450
"2011","Harrow","E09000015","Total",189258,106622,95871,10751,82636,53266,6110,3612,8585,11063
"2011","Havering","E09000016","Total",191305,110347,90932,19415,80958,49603,2232,3811,11399,13913
"2011","Hillingdon","E09000017","Total",210356,115259,96109,19150,95097,60518,5705,4591,12375,11908
"2011","Hounslow","E09000018","Total",200444,103627,84588,19039,96817,62839,7259,4976,12081,9662
"2011","Kingston upon Thames","E09000021","Total",126138,71238,57202,14036,54900,37508,2207,2226,6810,6149
"2011","Merton","E09000024","Total",159397,86166,67847,18319,73231,49544,4143,3333,8706,7505
"2011","Redbridge","E09000026","Total",214474,116035,101139,14896,98439,63951,6813,5099,10882,11694
"2011","Richmond upon Thames","E09000027","Total",147274,87376,68806,18570,59898,38524,2333,2672,9071,7298
"2011","Sutton","E09000029","Total",150716,87117,70095,17022,63599,39975,2162,3287,9557,8618
"2011","Waltham Forest","E09000031","Total",201503,95982,73669,22313,105521,70771,7011,5984,12534,9221
"2011","Bracknell Forest","E06000036","Total",87613,54996,43658,11338,32617,19463,1044,1748,5950,4412
"2011","Brighton and Hove","E06000043","Total",221950,107034,71743,35291,114916,81015,2573,4499,15755,11074
"2011","Isle of Wight","E06000046","Total",111118,67050,53683,13367,44068,22607,1325,2222,8907,9007
"2011","Medway","E06000035","Total",206625,121594,94489,27105,85031,51650,2130,5150,14030,12071
"2011","Milton Keynes","E06000042","Total",191356,115562,89344,26218,75794,45928,3052,4974,12883,8957
"2011","Portsmouth","E06000044","Total",162345,81549,59309,22240,80796,53136,2082,3781,12647,9150
"2011","Reading","E06000038","Total",121356,65117,49291,15826,56239,38270,2659,2548,7023,5739
"2011","Slough","E06000039","Total",106152,56957,47230,9727,49195,30202,3968,3092,6687,5246
"2011","Southampton","E06000045","Total",187146,94559,69163,25396,92587,62358,2796,4066,13118,10249
"2011","West Berkshire","E06000037","Total",120655,79615,65070,14545,41040,23895,1132,2161,7180,6672
"2011","Windsor and Maidenhead","E06000040","Total",113209,70988,58602,12386,42221,25056,1830,2013,6662,6660
"2011","Wokingham","E06000041","Total",120636,81503,69220,12283,39133,23843,1255,1715,6167,6153
"2011","Aylesbury Vale","E07000004","Total",135468,87482,71234,16248,47986,28075,1651,2655,8206,7399
"2011","Chiltern","E07000005","Total",72917,48514,42102,6412,24403,13963,770,1063,3820,4787
"2011","South Bucks","E07000006","Total",53265,33918,29048,4870,19347,11127,816,822,2915,3667
"2011","Wycombe","E07000007","Total",134583,83408,69086,14322,51175,31490,2136,2495,7530,7524
"2011","Eastbourne","E07000061","Total",80430,44321,34202,10119,36109,19836,1020,1963,7003,6287
"2011","Hastings","E07000062","Total",71805,38365,27905,10460,33440,18950,797,2223,6957,4513
"2011","Lewes","E07000063","Total",78999,48718,39205,9513,30281,16353,798,1555,5669,5906
"2011","Rother","E07000064","Total",74173,45923,38068,7855,28250,13541,837,1527,5320,7025
"2011","Wealden","E07000065","Total",119869,78337,65835,12502,41532,21971,1191,2120,7537,8713
"2011","Basingstoke and Deane","E07000084","Total",132812,86055,68895,17160,46757,27492,1309,2585,8325,7046
"2011","East Hampshire","E07000085","Total",92013,60813,51448,9365,31200,17332,881,1543,5584,5860
"2011","Eastleigh","E07000086","Total",100561,64475,52036,12439,36086,20728,821,1880,6672,5985
"2011","Fareham","E07000087","Total",90757,59944,50140,9804,30813,17069,654,1598,5438,6054
"2011","Gosport","E07000088","Total",65549,39562,30926,8636,25987,14134,566,1605,5385,4297
"2011","Hart","E07000089","Total",71116,48888,41320,7568,22228,13021,727,1092,3605,3783
"2011","Havant","E07000090","Total",97560,59690,47904,11786,37870,20810,802,2037,6946,7275
"2011","New Forest","E07000091","Total",144783,93332,78362,14970,51451,26479,1421,2483,9650,11418
"2011","Rushmoor","E07000092","Total",72942,44703,35364,9339,28239,17127,1393,1517,4721,3481
"2011","Test Valley","E07000093","Total",92852,61559,51210,10349,31293,17341,976,1772,5676,5528
"2011","Winchester","E07000094","Total",90637,58460,48712,9748,32177,18992,930,1387,5170,5698
"2011","Ashford","E07000105","Total",92512,59329,47148,12181,33183,18814,977,1967,5711,5714
"2011","Canterbury","E07000106","Total",117822,65777,52510,13267,52045,33098,1273,2189,7388,8097
"2011","Dartford","E07000107","Total",76368,45750,35254,10496,30618,18920,943,1764,4746,4245
"2011","Dover","E07000108","Total",89540,54254,42972,11282,35286,19058,867,2078,6686,6597
"2011","Gravesham","E07000109","Total",80248,47379,37812,9567,32869,19511,1355,1824,4940,5239
"2011","Maidstone","E07000110","Total",122830,78139,62537,15602,44691,26177,1224,2481,7403,7406
"2011","Sevenoaks","E07000111","Total",91365,59317,49346,9971,32048,18318,904,1536,5270,6020
"2011","Folkestone and Hythe","E07000112","Total",86951,51326,40279,11047,35625,19456,1091,2136,6682,6260
"2011","Swale","E07000113","Total",106102,66043,51022,15021,40059,22798,920,2592,7037,6712
"2011","Thanet","E07000114","Total",106434,60283,46440,13843,46151,24273,1228,2859,9261,8530
"2011","Tonbridge and Malling","E07000115","Total",94616,61671,50104,11567,32945,19002,785,1803,5669,5686
"2011","Tunbridge Wells","E07000116","Total",89556,56138,44596,11542,33418,19639,1009,1765,5756,5249
"2011","Cherwell","E07000177","Total",110843,71564,56873,14691,39279,23184,1310,1934,6781,6070
"2011","Oxford","E07000178","Total",108882,51183,38567,12616,57699,41591,2439,2035,6373,5261
"2011","South Oxfordshire","E07000179","Total",105747,70043,57918,12125,35704,20767,1110,1540,5955,6332
"2011","Vale of White Horse","E07000180","Total",95527,62957,52302,10655,32570,18960,993,1514,5282,5821
"2011","West Oxfordshire","E07000181","Total",83129,55133,45050,10083,27996,15802,818,1312,5144,4920
"2011","Elmbridge","E07000207","Total",101685,65771,55176,10595,35914,20724,1365,1751,6060,6014
"2011","Epsom and Ewell","E07000208","Total",59429,37022,31146,5876,22407,13867,691,1012,3171,3666
"2011","Guildford","E07000209","Total",106450,65728,54005,11723,40722,26328,1238,1729,5701,5726
"2011","Mole Valley","E07000210","Total",68315,44169,37350,6819,24146,13431,721,1220,4094,4680
"2011","Reigate and Banstead","E07000211","Total",107549,68416,55230,13186,39133,23448,1324,1814,6184,6363
"2011","Runnymede","E07000212","Total",63539,37405,30328,7077,26134,16268,909,1144,3889,3924
"2011","Spelthorne","E07000213","Total",77342,46723,37676,9047,30619,18210,1144,1523,4789,4953
"2011","Surrey Heath","E07000214","Total",67779,44984,37814,7170,22795,13514,858,1033,3657,3733
"2011","Tandridge","E07000215","Total",65169,41831,34318,7513,23338,13347,773,1199,3903,4116
"2011","Waverley","E07000216","Total",93982,61886,52553,9333,32096,17721,1015,1637,5502,6221
"2011","Woking","E07000217","Total",78272,49526,40797,8729,28746,17345,1411,1414,4333,4243
"2011","Adur","E07000223","Total",49915,30292,23720,6572,19623,10492,449,1009,3643,4030
"2011","Arun","E07000224","Total",122430,75222,61188,14034,47208,23462,1500,2493,9104,10649
"2011","Chichester","E07000225","Total",92491,57450,48222,9228,35041,18668,1119,1660,6165,7429
"2011","Crawley","E07000226","Total",83824,48261,37797,10464,35563,21640,1501,1788,5803,4831
"2011","Horsham","E07000227","Total",104904,68963,57796,11167,35941,19946,1065,1746,6376,6808
"2011","Mid Sussex","E07000228","Total",110615,71497,59336,12161,39118,22486,1006,2007,6788,6831
"2011","Worthing","E07000229","Total",84097,48790,38264,10526,35307,19400,839,1894,6980,6194
"2011","Bath and North East Somerset","E06000022","Total",140675,80810,65130,15680,59865,38712,1546,2101,8728,8778
"2011","Bournemouth","E06000028","Total",150950,77634,57531,20103,73316,46590,2153,3151,12088,9334
"2011","Bristol, City of","E06000023","Total",340467,170517,121294,49223,169950,118004,5145,7082,21559,18160
"2011","Cornwall","E06000052","Total",433668,270675,215935,54740,162993,87028,4597,7195,32315,31858
"2011","Isles of Scilly","E06000053","Total",1786,1194,958,236,592,299,18,26,108,141
"2011","North Somerset","E06000024","Total",162604,103440,84748,18692,59164,31684,1567,3132,11560,11221
"2011","Plymouth","E06000026","Total",206292,115912,88293,27619,90380,55578,2066,4066,16023,12647
"2011","Poole","E06000029","Total",119629,73049,58448,14601,46580,25636,1363,2220,8823,8538
"2011","South Gloucestershire","E06000025","Total",208307,132501,107826,24675,75806,45114,2268,3552,12759,12113
"2011","Swindon","E06000030","Total",166482,102209,79062,23147,64273,38123,2254,3715,11203,8978
"2011","Torbay","E06000027","Total",106336,62033,49166,12867,44303,22728,1153,2333,9590,8499
"2011","Wiltshire","E06000054","Total",368240,240854,198642,42212,127386,69952,3606,6708,24130,22990
"2011","East Devon","E07000040","Total",109110,70663,59424,11239,38447,18556,1107,1783,7438,9563
"2011","Exeter","E07000041","Total",93166,48862,36657,12205,44304,29363,992,1596,6741,5612
"2011","Mid Devon","E07000042","Total",62421,41082,33286,7796,21339,11353,605,1143,3996,4242
"2011","North Devon","E07000043","Total",75394,47787,38682,9105,27607,14783,795,1339,5090,5600
"2011","South Hams","E07000044","Total",68544,44313,36917,7396,24231,12178,771,1138,4972,5172
"2011","Teignbridge","E07000045","Total",100935,64643,52460,12183,36292,18592,930,1675,7397,7698
"2011","Torridge","E07000046","Total",52468,33888,27813,6075,18580,9695,484,953,3554,3894
"2011","West Devon","E07000047","Total",43192,28602,23690,4912,14590,7606,429,661,2737,3157
"2011","Christchurch","E07000048","Total",39855,25036,20828,4208,14819,7153,462,635,2797,3772
"2011","East Dorset","E07000049","Total",72628,49094,42696,6398,23534,11786,718,1054,4085,5891
"2011","North Dorset","E07000050","Total",54032,36068,29984,6084,17964,9403,585,913,3295,3768
"2011","Purbeck","E07000051","Total",37072,23809,19842,3967,13263,6801,445,547,2500,2970
"2011","West Dorset","E07000052","Total",81346,52472,43882,8590,28874,14400,835,1380,5527,6732
"2011","Weymouth and Portland","E07000053","Total",52525,31496,24840,6656,21029,11060,536,1088,4515,3830
"2011","Cheltenham","E07000078","Total",93134,52377,39662,12715,40757,25879,981,1785,6514,5598
"2011","Cotswold","E07000079","Total",67676,44204,36990,7214,23472,12541,789,1104,4117,4921
"2011","Forest of Dean","E07000080","Total",66078,43233,35266,7967,22845,12401,638,1047,4042,4717
"2011","Gloucester","E07000081","Total",95805,57447,43982,13465,38358,23167,1099,2013,6603,5476
"2011","Stroud","E07000082","Total",91225,59137,47850,11287,32088,17867,844,1601,5738,6038
"2011","Tewkesbury","E07000083","Total",66471,43940,35716,8224,22531,12058,601,1124,4282,4466
"2011","Mendip","E07000187","Total",86478,54448,43664,10784,32030,17688,814,1634,6271,5623
"2011","Sedgemoor","E07000188","Total",92555,59344,47454,11890,33211,17819,914,1764,6091,6623
"2011","South Somerset","E07000189","Total",129799,84350,68834,15516,45449,24139,1208,2223,8512,9367
"2011","Taunton Deane","E07000190","Total",87207,54279,43599,10680,32928,17868,942,1702,6292,6124
"2011","West Somerset","E07000191","Total",28472,17960,14826,3134,10512,4923,378,500,2105,2606
"2011","Isle of Anglesey","W06000001","Total",57083,33951,27456,6495,23132,12757,709,943,4075,4648
"2011","Gwynedd","W06000002","Total",97060,54061,42426,11635,42999,25673,1378,1520,6579,7849
"2011","Conwy","W06000003","Total",93547,55282,44512,10770,38265,20146,1148,1723,7267,7981
"2011","Denbighshire","W06000004","Total",75596,44936,35952,8984,30660,17026,792,1399,5712,5731
"2011","Flintshire","W06000005","Total",123049,75537,60946,14591,47512,27397,1129,2199,8506,8281
"2011","Wrexham","W06000006","Total",107444,64346,50648,13698,43098,25269,1085,1740,7812,7192
"2011","Powys","W06000023","Total",108328,67017,54520,12497,41311,22574,1229,1816,7158,8534
"2011","Ceredigion","W06000008","Total",60218,33538,26808,6730,26680,16487,744,972,3914,4563
"2011","Pembrokeshire","W06000009","Total",98521,59617,48906,10711,38904,20973,1151,1706,7228,7846
"2011","Carmarthenshire","W06000010","Total",148278,88565,72635,15930,59713,33012,1436,2362,10807,12096
"2011","Swansea","W06000011","Total",192979,103995,83932,20063,88984,55143,2067,3705,14386,13683
"2011","Neath Port Talbot","W06000012","Total",114057,66102,53344,12758,47955,26972,918,2035,9248,8782
"2011","Bridgend","W06000013","Total",111560,67012,53986,13026,44548,25224,909,1979,8486,7950
"2011","Vale of Glamorgan","W06000014","Total",100451,60542,49213,11329,39909,22691,970,1881,7489,6878
"2011","Cardiff","W06000015","Total",271649,137261,104327,32934,134388,92450,3903,4941,17788,15306
"2011","Rhondda Cynon Taff","W06000016","Total",187600,107360,85300,22060,80240,47850,1543,3510,13517,13820
"2011","Merthyr Tydfil","W06000024","Total",47379,26581,20778,5803,20798,12707,469,961,3272,3389
"2011","Caerphilly","W06000018","Total",142780,85616,67466,18150,57164,33609,1099,2385,10166,9905
"2011","Blaenau Gwent","W06000019","Total",56746,31719,24738,6981,25027,14629,460,1053,4487,4398
"2011","Torfaen","W06000020","Total",73121,43473,34372,9101,29648,16695,624,1306,5529,5494
"2011","Monmouthshire","W06000021","Total",73620,47260,39420,7840,26360,14316,794,1181,4812,5257
"2011","Newport","W06000022","Total",114728,64325,51170,13155,50403,30271,1566,2374,8352,7840
